10
10
"P","P","P","P","P","P","P","P","P","P"
"P","F","F","F","F","F","F","F","F","P"
"P","F","F","F","F","F","C","F","F","P"
"P","F","F","F","F","F","F","F","F","P"
"P","F","F","F","F","F","F","F","F","P"
"P","F","F","F","F","P","P","P","P","P"
"P","F","F","F","F","P","F","F","F","P"
"P","F","F","F","F","F","F","P","F","P"
"P","Z","W","F","F","F","F","P","M","P"
"P","P","P","P","P","P","P","P","P","P"
3
3
